######
#    #
# o @#
#..o #
######
